111111111111111111111111111111111111111
10P1000C0000000C0000000000C0000111110C1
1000C000C111100000C0000C0000C0010000001
1C0011000000000C00C00C0000000C0000C0001
1000C10C01111000C0000010010000000C01001
100110C001111000C0000000110000100111111
100C0010011100000000000C000000100111001
100110000111100000C00110000000101000011
100C01111100000000111000011100011000111
10000110011110000C00000C000C00010000111
111110000000E00000C0111111C000001111111
111111111111111111111111111111111111111
