1111111111111111111111111111111111
100000000000000C00000C00000000P001
101001010P:w
100000101001000000010101
1010010010101010001001000000010101
100000000C00C00000000000000E0000C1
1111110001111111111111111111111111
