1111111111111
1P00000001CE1
1000000000001
1000000P00001
1111111111111
