1111111111111
10E00CP000P01
1000C000C0001
1111111111111
