1111111111111111111
1E00000000000000001
1111111000000000001
1P10000000000001111
1100000000000000111
1110000000000000111
1111111111111111111
