1111111111111111111
1E1111000000C000001
111111100000000C001
1P10000000000001111
1100000000000000111
1110000000000000111
1111111111111111111
