1111111111111111111
1E0000000000P000001
1111111000000000001
1110000000000001111
1100000000000000111
1000000000C00000111
1111111111111111111
