11111111111111111111111111
100000PE000000000000000001
10000000000000CC0000000001
10000000000000000000000011
11111111111111111111111111
