1111111111111111111
1E1111000000C000001
111111100000000C001
1P00000000000001111
1110000000000001111
1111111111111111111
