111111111111111111111111111111111111
10P100000000000C00000000000C000000C1
100000000111100000000000C00000001001
1000110000000000000000C0000000C00001
10000000011110000C000001001000001001
10000000011110000C000000011000001001
100000000111100000000000C00000001001
1000000001111000000C0011000000001001
100001111100000000111100001111000111
10000000011110000C000000000000001001
111110000000E0000000111111C000000011
111111111111111111111111111111111111
