11111111111111111
10P10000C000000C1
10000000011111001
10001100000000001
10000111110000111
11111C000000E0011
11111111111111111
