1111111
1E11111
0C11111
1P11111
1111111
