111111
1P1CE1
100001
100001
111111